5 2 216 2171 
4 18 1258 3869 3906 366 3114 4012 1909 776 1941 518 452 2053 3998 427 3990 3989 1322 216 
1 17 1950 3739 18 2063 266 2325 3909 2275 2622 1729 2556 2105 2822 2457 2126 3014 1909 
2 16 1258 3828 1421 1015 3727 1122 2526 1173 2479 3548 2740 1904 3451 2216 2621 3418 
2 16 3418 253 358 534 3421 2584 3437 3454 929 1332 2366 414 479 1978 2114 2292 
2 39 2171 989 1109 3026 2558 4095 1104 4139 2054 1171 4195 485 4230 2038 822 2620 373 1560 1817 2260 1394 1633 2905 722 4419 694 2316 1414 2052 635 1726 4477 85 3147 2320 1505 2083 1439 1877 
3 9 4073 3145 4043 4032 1699 2872 2938 2171 3945 
3 11 2706 3095 2387 1499 4011 4000 1867 216 1691 1947 3920 
2 8 3535 2916 478 1340 2869 2761 22 3150 
1 30 4057 2136 4061 245 4030 38 779 248 3993 1110 3172 1539 912 2395 1126 3875 2455 3821 425 3139 2403 3709 1193 2234 2523 3585 1340 478 2916 3535 
2 36 2322 3614 1254 2789 408 3715 3105 407 1239 3835 237 944 3099 1133 417 3979 1539 21 4010 3092 1139 4038 637 4081 893 2506 4149 2054 4139 1104 4095 2558 3026 1109 989 2171 
1 12 2322 3563 1646 3501 3485 44 2306 3439 316 3441 2820 1404 
2 24 1561 1650 1120 165 2102 1232 3621 3651 715 3706 3025 814 2430 2043 3836 1199 2618 2510 3961 2946 938 1599 4054 4042 
1 24 1539 96 4025 4037 2796 173 3186 4123 1022 4163 1098 664 1686 2817 186 2968 4240 1410 2581 717 4293 735 2182 4303 
1 22 2322 2183 3580 1660 580 3507 983 3460 2648 222 2108 3389 2061 3381 2436 3371 2534 2159 490 1059 198 503 
1 8 3725 3714 2941 872 1314 1680 3704 3715 
1 8 1561 3473 498 3478 2441 3492 2254 3518 
1 7 3823 3843 3872 2770 3941 3932 2510 
1 6 4154 719 2480 67 4054 4042 
1 12 2292 2414 1178 2802 1844 932 2185 1172 1475 3661 1807 821 
4 18 2542 1134 1630 4289 2282 2073 4316 2002 4333 1189 2059 2327 766 3097 4313 117 2625 3188 
4 7 4270 2165 2359 211 2452 4324 2059 
2 29 3188 2244 2923 1142 2546 3159 2718 2305 249 1525 2015 196 3061 4344 1282 4358 2150 389 1800 1835 3017 2123 683 19 2678 24 4484 803 188 
3 22 3188 128 4285 4309 4331 1386 3082 4368 2974 2087 2045 4394 838 4415 2312 4407 331 1417 2714 3078 297 1118 
4 24 4489 392 2017 4483 873 2392 257 4473 3 1682 4450 4435 2118 2819 4410 2243 918 2201 4321 4306 1430 1187 128 3188 
2 12 2839 934 1303 2352 251 484 1964 1031 4434 4429 728 2118 
1 11 4489 1280 235 1725 1490 4476 2219 1364 1986 4465 2645 
1 8 1118 4350 2400 1786 4352 4366 1151 4391 
3 2 4263 3159 
2 7 4506 1392 4509 940 632 2345 2503 
2 22 821 1512 3743 2289 1584 1217 2522 672 2385 2612 1597 3866 756 3913 3940 2247 1901 3969 2697 2528 62 3982 
1 5 4526 3069 385 2307 2289 
1 16 3041 3414 1402 897 459 2887 570 1271 189 1746 1698 2161 3040 1645 3415 181 
2 14 75 1878 14782 2806 1664 2988 1743 2034 505 1337 1614 2370 1124 181 
2 43 181 1374 2530 1634 2301 1500 3184 3467 3484 1388 3526 660 3571 1881 1815 2357 1042 3688 215 14 397 3004 1937 2882 391 2657 1730 451 2362 2932 701 2303 1719 3938 2449 2461 3977 2565 236 1416 4007 1985 3982 
1 7 3603 3634 54 2139 2696 1738 14 
2 32 1719 1223 1758 492 2862 2141 2134 4058 1300 4108 4126 1100 1961 455 2895 4209 2920 1352 4229 2592 440 4259 888 4291 1848 4325 1741 4337 501 4348 2160 4378 
1 9 1923 4278 2576 32 2919 1273 406 2448 4126 
1 20 2032 1659 616 2695 2388 1476 1983 2012 43 2887 570 1271 189 1746 1698 2161 3040 1645 3415 181 
2 25 3607 2177 2653 1547 1829 2548 3555 3572 1011 911 3680 1297 1527 2661 624 61 1737 2981 3064 3847 2864 1509 3948 1916 3982 
3 12 3982 4008 2840 4046 1137 4094 144 4116 1805 3136 602 3011 
1 9 1233 2354 192 3356 2492 884 2590 548 2042 
2 16 181 3406 2713 195 3355 2069 3325 1604 1225 2470 74 2319 3151 2444 895 3259 
5 7 3259 3015 1808 2662 3240 3154 2568 
3 19 3228 1790 2626 3246 1237 72 349 2701 2986 525 3250 1390 3248 429 1265 3245 1044 2571 2662 
2 5 281 2217 93 2138 3228 
3 9 3244 984 476 83 2181 190 1735 3249 2568 
2 15 3244 1485 3000 1296 994 3235 1339 942 1902 937 581 3236 1869 255 2755 
1 8 1714 700 1093 3255 1346 3258 2956 581 
3 16 1567 413 3334 3324 1976 1750 2005 3310 3296 1182 3282 3121 1852 314 1883 3244 
3 4 310 3196 202 1149 
1 7 1149 437 1823 49 1963 2540 994 
1 6 3208 720 1013 431 161 1470
2 4 4515 1463 1355 4522 
1 24 657 457 340 163 4524 2629 809 1795 1684 1206 539 160 1623 365 4513 1144 1709 2960 1160 4512 691 2642 1463 4515 
1 9 781 2635 677 1089 267 633 688 2094 4515 